Avtorji, Tezavnost, Cas priprave, Cas kuhanja, Skupen cas, Dolzina navodil
M.J. , 1 , 15 , 40 , 55 , 1276
Su.S. , 1 , 20 , 40 , 60 , 1290
Sanja Sirk , 1 , 15 , 35 , 50 , 1525
M. J. , 1 , 10 , 30 , 40 , 1116
M. J. , 1 , 20 , 90 , 110 , 2125
Su.S. , 1 , 35 , 55 , 90 , 836
Su.S. , 1 , 25 , 25 , 50 , 886
M. J. , 1 , 55 , 10 , 65 , 925
M. J. , 1 , 40 , 240 , 280 , 1712
Su.S. , 1 , 15 , 0 , 15 , 696
